NO ./textures/128_blockDiamond.xpm

SO ./textures/128_bookshelf.xpm
WE ./textures/128_grass_side.xpm

EA ./textures/128_oreGold.xpm

F 51,51,51
C 204,204,204

1111111111111111111111111
100000000011000000000000111
10110000011100000000000011
100100000000000000000000001
111111111011000001110000011111
100000000011000001110111111111111
11110111111111011100000010001
11110111111111011101010000001
11000000110101011100000010001
10000000000000001100000000001
10000000000000001101010000001
11000001110101011111011100N0111
11110111 1110101 101111010001
11111111 1111111 111111111111
